##########
#    ### #
###    # #
S   #  # #
#####    #
#   #### #
###      #
#   ## # E
#   #  # #
##########