########################  #
#S      #           #  #  #
# #### ### ######### #  # #
# #  #   #   #     # #  # #
# #  #  ### ### ### #    ##
# #  #  #   #   #   # #####
# #  #### ### ### ###    ##
# #   #     #   #      ####
# #   ##### ## #### ##   ##
# ######              #  ##
#    ##### ##  #######  E##
# ###    ##   ## ##########
#   # #     #   #    #  ###
# ### ##### ##### ### #####
#   # #     #     #     ###
# ##### # ### ##### ##### #
#      #  #    #    #    ##
### #    # #  #####  ######
#   #    ###    ###     ###
###########################